######
#    #
# @  #
# $$ #
# .. #
######
